Last Name	First Name
Patil	Aryan
Sapp	Ben
Barnhill	Carson
Blackburn	Casen
Baik	Chan
Burns	Chandler
Haliburton	Davis
Braun	George
Ebba	Hannah
Mann	Joey
Eccleston	Jordan
Singleton	Kaylie
Griffy	Logan
Maria-Sklodowska	Curie
Matthaeus	Maurice
Allgaier	Max
Soldevilla	Miguel
Dixon	Nyran
McMillen	Ostyn
Woodson	Persephone
Deloach	Rhys
Baumbick	Sam
Roy	Swapnil
Lee	Xavier
Lee	Yonghoon
